the	Det
man	Noun
saw	Verb
with	Prep
a	Det
telescope	Noun
boy	Noun
davis	Noun
won	Verb
gold	Noun
medal	Noun
at	Prep
vancouver	Noun
olympics	Noun
which	Pronoun
races	Noun
did	Aux
lindsey	ProperNoun
vonn	ProperNoun
win	Verb
italian	ProperNoun
skater	ProperNoun
who	Pronoun
in	Prep
torino	ProperNoun
lost	Verb
